,article_size,summary_size,prompt_tokens,completion_tokens,total_tokens,status,lang,delta,id
0,1539,436,1282,197,1479,200,ru,6.11516,8
1,3489,425,2164,194,2358,200,ru,9.551833,9
2,7135,605,3864,276,4140,200,ru,7.379068,11
3,1593,634,1316,289,1605,200,ru,8.584833,14
4,2533,232,1747,104,1851,200,ru,4.001243,2
5,2187,323,1587,146,1733,200,ru,5.155237,4
6,877,279,998,130,1128,200,ru,3.356129,16
7,2119,448,1562,205,1767,200,ru,5.791127,19
8,877,279,998,130,1128,200,ru,3.460303,16
9,3619,544,1466,136,1602,200,en,4.485392,95
10,2684,661,1208,165,1373,200,en,5.101184,96
11,3405,538,2143,245,2388,200,ru,7.277757,407
12,476,67,805,29,834,200,ru,1.653841,21
13,901,133,1005,63,1068,200,ru,1.67241,23
14,1367,356,1214,164,1378,200,ru,4.725917,24
15,745,127,928,58,986,200,ru,2.171844,25
16,1830,214,1427,99,1526,200,ru,3.706536,26
17,435,166,787,74,861,200,ru,3.112207,29
18,2558,469,1760,217,1977,200,ru,6.535619,30
19,1400,305,1233,138,1371,200,ru,4.254814,31
20,1830,186,1427,86,1513,200,ru,2.621983,26
21,1812,217,1414,101,1515,200,ru,2.793721,32
22,1322,165,1184,76,1260,200,ru,2.445192,33
23,2416,442,1674,204,1878,200,ru,4.581027,34
24,1563,368,1295,170,1465,200,ru,4.764674,35
25,2648,218,1800,102,1902,200,ru,3.12972,36
26,1057,278,1055,121,1176,200,ru,3.696569,45
27,2370,393,1668,178,1846,200,ru,4.716975,38
28,1655,390,1333,175,1508,200,ru,5.289426,39
29,1842,508,1426,231,1657,200,ru,6.002199,40
30,20678,500,9782,222,10004,200,ru,8.229144,125
31,7769,640,4105,291,4396,200,ru,8.009817,408
32,96,45,635,20,655,200,ru,1.310031,409
33,2315,211,1634,99,1733,200,ru,2.955255,41
34,1833,310,1420,144,1564,200,ru,3.998869,42
35,2060,406,1524,187,1711,200,ru,5.301266,43
36,2060,392,1524,180,1704,200,ru,4.562568,43
37,1153,499,1115,229,1344,200,ru,6.468673,47
38,3426,364,2151,165,2316,200,ru,4.916819,48
39,1884,400,1443,182,1625,200,ru,5.035662,49
40,2647,562,1793,256,2049,200,ru,6.434237,50
41,2032,279,1507,130,1637,200,ru,4.091219,51
42,1741,178,1363,79,1442,200,ru,3.37554,52
43,1164,153,1110,70,1180,200,ru,2.787552,53
44,1956,272,1465,121,1586,200,ru,4.219102,54
45,1569,198,1303,91,1394,200,ru,3.124012,55
46,1745,294,1377,132,1509,200,ru,4.066927,59
47,1627,368,1323,165,1488,200,ru,5.211224,60
48,2375,434,1666,200,1866,200,ru,5.204942,61
49,1642,453,1331,207,1538,200,ru,5.309009,62
50,1408,254,1215,114,1329,200,ru,3.240893,63
51,6790,1320,2258,330,2588,200,en,10.001116,2279
52,1739,128,1375,55,1430,200,ru,2.474534,64
53,2426,833,1692,381,2073,200,ru,7.972823,65
54,2833,470,1885,214,2099,200,ru,5.616007,66
55,964,256,1028,118,1146,200,ru,3.684153,69
56,708,182,913,84,997,200,ru,2.928785,70
57,1038,379,1071,176,1247,200,ru,4.592936,71
58,842,238,980,109,1089,200,ru,3.364521,72
59,720,191,904,83,987,200,ru,3.672048,78
60,2035,493,1518,225,1743,200,ru,5.513455,73
61,899,453,992,199,1191,200,ru,7.357482,74
62,542,122,833,54,887,200,ru,2.54578,75
63,754,374,931,167,1098,200,ru,4.197145,76
64,1191,255,1139,117,1256,200,ru,3.659124,77
65,552,144,838,65,903,200,ru,2.310933,83
66,1946,433,1488,199,1687,200,ru,7.286324,84
67,902,120,999,54,1053,200,ru,2.221864,85
68,5138,551,1833,137,1970,200,en,4.083023,86
69,683,228,703,57,760,200,en,1.829602,87
70,1019,327,788,81,869,200,en,2.952451,88
71,471,220,649,55,704,200,en,1.934162,89
72,538,226,671,56,727,200,en,2.033488,90
73,582,237,679,59,738,200,en,2.456314,91
74,2591,564,1190,141,1331,200,en,4.84887,98
75,3010,541,1299,135,1434,200,en,4.305857,99
76,3726,656,1477,164,1641,200,en,6.04276,100
77,2400,687,1141,171,1312,200,en,4.812424,101
78,2412,505,1140,126,1266,200,en,4.048775,102
79,4112,754,1575,188,1763,200,en,5.207632,103
80,3270,582,1364,145,1509,200,en,4.694093,104
81,4150,601,1579,150,1729,200,en,5.207365,105
82,1276,368,1166,169,1335,200,ru,4.19525,106
83,1341,379,1186,162,1348,200,ru,5.047959,107
84,804,380,952,167,1119,200,ru,4.730519,113
85,994,312,1049,142,1191,200,ru,3.771752,114
86,741,314,909,141,1050,200,ru,4.487993,115
87,672,188,892,84,976,200,ru,3.773537,116
88,1234,222,1150,102,1252,200,ru,3.273126,117
89,2553,266,1723,118,1841,200,ru,5.140462,118
90,17906,1089,5112,272,5384,200,en,7.631458,675
91,4199,743,1587,185,1772,200,en,6.64337,676
92,1580,583,1317,271,1588,200,ru,6.180747,119
93,90,254,633,118,751,200,ru,3.597233,124
94,4288,821,1605,205,1810,200,en,7.025536,695
95,2403,477,1140,119,1259,200,en,4.141854,126
96,4651,669,1710,167,1877,200,en,4.759812,127
97,7900,786,2529,196,2725,200,en,6.069588,128
98,1937,456,1020,114,1134,200,en,3.383386,129
99,5847,627,2028,156,2184,200,en,5.671583,130
100,7021,1066,2321,266,2587,200,en,7.144507,131
101,1971,552,1023,138,1161,200,en,4.712694,132
102,3825,597,1487,149,1636,200,en,4.448838,133
103,2371,519,1137,129,1266,200,en,3.86478,136
104,893,566,754,141,895,200,en,4.283652,137
105,6599,545,2215,136,2351,200,en,4.285558,138
106,7398,647,2381,161,2542,200,en,5.714208,139
107,316,196,611,49,660,200,en,2.487545,140
108,280,202,603,50,653,200,en,5.770539,141
109,2609,697,1196,174,1370,200,en,5.036155,142
110,656,261,894,121,1015,200,ru,3.513721,164
111,1262,442,848,110,958,200,en,4.351094,143
112,562,191,673,47,720,200,en,2.25998,144
113,562,187,673,46,719,200,en,1.525774,144
114,1496,337,905,84,989,200,en,2.924292,150
115,2027,449,1511,209,1720,200,ru,4.948391,151
116,1345,488,1198,224,1422,200,ru,5.623928,152
117,2016,475,1503,216,1719,200,ru,5.54651,153
118,2803,421,1850,192,2042,200,ru,4.385507,154
119,4004,748,2405,341,2746,200,ru,7.939078,165
120,2606,295,1761,132,1893,200,ru,4.988009,166
121,4965,485,2845,221,3066,200,ru,5.4544,167
122,1866,503,1426,229,1655,200,ru,5.824568,155
123,3961,322,2400,147,2547,200,ru,4.711207,168
124,4472,529,2618,234,2852,200,ru,7.629294,169
125,7250,660,2364,165,2529,200,en,6.490853,2192
126,2087,464,1535,211,1746,200,ru,5.890819,159
127,1672,357,1340,163,1503,200,ru,4.495329,160
128,1789,292,1387,130,1517,200,ru,3.994347,161
129,2387,473,1678,220,1898,200,ru,5.361091,162
130,11842,737,5949,308,6257,200,ru,14.669743,170
131,5792,241,3213,106,3319,200,ru,4.339934,171
132,6355,930,2138,232,2370,200,en,6.341538,2322
133,2027,201,1508,93,1601,200,ru,2.979493,176
134,1858,512,1433,232,1665,200,ru,6.697516,177
135,1143,369,1105,166,1271,200,ru,5.812315,185
136,1811,238,1408,106,1514,200,ru,3.258562,178
137,930,423,1012,195,1207,200,ru,5.412666,179
138,796,106,950,48,998,200,ru,1.829154,180
139,11424,514,5733,237,5970,200,ru,7.363369,181
140,469,152,805,68,873,200,ru,2.327711,182
141,2417,417,1671,190,1861,200,ru,5.2741,183
142,991,341,1037,152,1189,200,ru,4.579623,184
143,5777,449,3210,201,3411,200,ru,5.946332,229
144,2106,322,1549,147,1696,200,ru,5.087483,230
145,790,182,950,83,1033,200,ru,3.681709,191
146,1406,195,1220,88,1308,200,ru,2.503531,192
147,1328,210,1183,92,1275,200,ru,3.200683,193
148,1106,304,1095,139,1234,200,ru,4.017898,195
149,1703,372,1349,168,1517,200,ru,4.481684,196
150,641,207,878,93,971,200,ru,3.123051,198
151,939,301,992,130,1122,200,ru,3.962822,205
152,872,288,990,132,1122,200,ru,3.197678,206
153,1799,672,1404,312,1716,200,ru,6.909724,207
154,4258,534,2545,246,2791,200,ru,6.4269,208
155,1204,290,1143,130,1273,200,ru,3.771143,209
156,1631,372,1332,171,1503,200,ru,4.38554,210
157,2619,349,1742,151,1893,200,ru,5.093927,231
158,7135,623,3864,283,4147,200,ru,7.773301,232
159,10698,1223,5463,545,6008,200,ru,13.911024,822
160,4437,416,1656,104,1760,200,en,4.164187,215
161,156,89,661,40,701,200,ru,2.035788,239
162,9086,249,4659,105,4764,200,ru,5.408188,240
163,4534,529,1699,132,1831,200,en,4.268531,241
164,1049,255,792,63,855,200,en,2.485157,216
165,770,242,723,60,783,200,en,2.21099,217
166,3487,657,1402,164,1566,200,en,4.371049,218
167,1653,117,1335,53,1388,200,ru,1.910012,219
168,1802,504,1418,232,1650,200,ru,5.549998,220
169,1492,391,1269,178,1447,200,ru,5.308259,221
170,1585,497,1326,231,1557,200,ru,5.170068,224
171,1031,263,1060,120,1180,200,ru,3.558725,225
172,7371,730,2397,182,2579,200,en,5.427198,226
173,3729,441,1481,110,1591,200,en,3.755085,227
174,2012,326,1506,149,1655,200,ru,3.751001,228
175,1091,387,1084,179,1263,200,ru,4.601947,233
176,1724,218,1388,100,1488,200,ru,2.744677,234
177,1046,286,1072,132,1204,200,ru,3.770079,235
178,1449,168,1253,77,1330,200,ru,2.056956,236
179,1287,218,1179,101,1280,200,ru,2.684503,243
180,2395,351,1676,163,1839,200,ru,3.709266,244
181,7092,869,2329,217,2546,200,en,5.779202,246
182,494,245,656,61,717,200,en,1.946002,247
183,2014,403,1507,184,1691,200,ru,5.845301,248
184,1705,384,1365,174,1539,200,ru,4.982605,249
185,1226,333,1152,154,1306,200,ru,3.96269,250
186,1173,469,1129,216,1345,200,ru,5.555813,251
187,308,170,731,78,809,200,ru,1.666066,263
188,1108,379,808,94,902,200,en,3.569177,257
189,1328,311,862,77,939,200,en,2.906779,258
190,1631,182,1333,84,1417,200,ru,2.696108,259
191,3489,325,2164,145,2309,200,ru,5.202175,260
192,1261,331,848,82,930,200,en,2.399483,261
193,1941,346,1476,158,1634,200,ru,4.637813,262
194,1371,339,1208,157,1365,200,ru,4.485066,264
195,1507,325,1275,147,1422,200,ru,4.389483,265
196,907,162,1005,76,1081,200,ru,2.424511,269
197,2982,595,1290,148,1438,200,en,4.696981,270
198,4617,775,1684,193,1877,200,en,4.997218,271
199,6324,802,2112,200,2312,200,en,5.936351,272
200,1840,452,992,113,1105,200,en,3.552032,273
201,899,243,1005,110,1115,200,ru,3.975022,274
202,832,221,970,102,1072,200,ru,3.367492,275
203,1472,99,1263,45,1308,200,ru,2.031686,277
204,1045,323,1067,149,1216,200,ru,4.599533,278
205,751,196,932,89,1021,200,ru,2.647751,279
206,557,232,849,108,957,200,ru,3.451059,285
207,2840,516,1874,236,2110,200,ru,5.90578,286
208,492,122,811,55,866,200,ru,2.455343,287
209,3972,416,2344,179,2523,200,ru,5.936322,288
210,2911,491,1931,226,2157,200,ru,6.522542,289
211,2209,337,1601,156,1757,200,ru,3.977759,290
212,669,193,888,86,974,200,ru,3.05814,291
213,9140,883,4793,408,5201,200,ru,9.942866,292
214,1957,438,1476,196,1672,200,ru,6.806232,293
215,4642,572,1712,143,1855,200,en,5.13534,294
216,3249,504,1348,126,1474,200,en,4.14303,302
217,4534,597,1674,149,1823,200,en,4.878056,303
218,1957,459,1476,205,1681,200,ru,6.657865,293
219,4642,659,1712,164,1876,200,en,5.3696,294
220,1099,293,805,73,878,200,en,2.659736,304
221,1861,406,1429,184,1613,200,ru,5.089457,305
222,2152,495,1566,227,1793,200,ru,6.73592,306
223,597,299,862,135,997,200,ru,3.673683,307
224,626,305,879,142,1021,200,ru,3.391802,308
225,286,105,603,26,629,200,en,1.390601,1436
226,768,333,944,152,1096,200,ru,3.682928,312
227,2818,579,1235,144,1379,200,en,4.047779,313
228,3637,700,1440,175,1615,200,en,4.301515,314
229,369,82,761,38,799,200,ru,1.466485,447
230,1094,278,804,69,873,200,en,2.602776,315
231,860,270,746,67,813,200,en,2.241813,316
232,1090,165,1093,77,1170,200,ru,2.256218,318
233,1477,212,1249,95,1344,200,ru,3.343933,319
234,1294,411,1177,189,1366,200,ru,4.882267,320
235,9459,1024,4793,450,5243,200,ru,14.721826,323
236,7053,800,3771,368,4139,200,ru,10.128461,324
237,1949,367,1472,166,1638,200,ru,5.979549,325
238,2113,512,1550,236,1786,200,ru,5.60192,326
239,1581,295,1306,136,1442,200,ru,3.457322,327
240,490,268,654,67,721,200,en,2.646056,1438
241,1424,476,1234,221,1455,200,ru,4.696723,328
242,2545,375,1758,175,1933,200,ru,3.787798,329
243,5025,673,1787,168,1955,200,en,4.277074,330
244,4831,837,1738,209,1947,200,en,5.818747,331
245,2146,515,1572,235,1807,200,ru,5.287497,338
246,2395,418,1676,194,1870,200,ru,5.0013,339
247,1631,278,1333,126,1459,200,ru,3.16131,340
248,5953,872,2028,218,2246,200,en,5.826829,341
249,16643,1839,4704,459,5163,200,en,14.016329,342
250,495,341,655,85,740,200,en,2.934869,343
251,8066,905,2559,226,2785,200,en,6.003547,344
252,7444,643,2392,160,2552,200,en,4.991929,345
253,1699,509,959,127,1086,200,en,4.384989,346
254,3268,695,2055,306,2361,200,ru,7.866422,2470
255,2824,376,1854,168,2022,200,ru,4.563871,369
256,2376,453,1672,210,1882,200,ru,5.925658,370
257,1502,146,1276,67,1343,200,ru,2.250762,387
258,1850,230,1430,104,1534,200,ru,2.908374,371
259,4656,426,2701,197,2898,200,ru,4.835191,372
260,3506,360,2180,162,2342,200,ru,4.8479,373
261,1828,321,1421,147,1568,200,ru,3.8396,374
262,3110,430,1308,107,1415,200,en,3.825596,375
263,1138,247,1116,115,1231,200,ru,3.053473,376
264,2978,536,1953,245,2198,200,ru,5.491772,377
265,1978,587,1492,273,1765,200,ru,5.808405,382
266,1642,465,1297,205,1502,200,ru,5.78462,388
267,2516,514,1741,238,1979,200,ru,6.383061,389
268,2098,452,1552,207,1759,200,ru,4.962343,383
269,941,182,1022,82,1104,200,ru,4.705005,384
270,1538,594,1285,271,1556,200,ru,7.562492,385
271,1475,105,1251,47,1298,200,ru,1.986795,386
272,2590,549,1759,250,2009,200,ru,6.811263,390
273,308,100,731,45,776,200,ru,1.376936,586
274,2076,148,1521,67,1588,200,ru,2.107155,391
275,2260,231,1585,100,1685,200,ru,3.237669,396
276,2187,280,1587,124,1711,200,ru,4.209465,406
277,1296,254,1162,116,1278,200,ru,3.64153,397
278,3206,557,1344,139,1483,200,en,4.246651,398
279,2282,456,1102,114,1216,200,en,4.187358,399
280,2371,506,1134,126,1260,200,en,3.643771,400
281,723,314,712,78,790,200,en,2.230426,401
282,8480,682,2689,170,2859,200,en,5.575275,402
283,2582,513,1182,128,1310,200,en,4.145083,403
284,4579,695,1700,173,1873,200,en,5.416257,404
285,1749,341,1385,157,1542,200,ru,3.742834,410
286,2035,203,1518,92,1610,200,ru,3.033169,411
287,1512,328,1274,152,1426,200,ru,4.611864,412
288,1027,198,1062,91,1153,200,ru,2.855175,413
289,3223,389,2053,178,2231,200,ru,4.887879,414
290,1022,304,1054,140,1194,200,ru,3.765262,415
291,1965,412,1023,103,1126,200,en,3.7743,416
292,2979,581,1289,145,1434,200,en,4.451467,417
293,2362,497,1658,227,1885,200,ru,5.090456,418
294,828,290,973,132,1105,200,ru,3.54231,419
295,981,199,1037,89,1126,200,ru,3.117314,424
296,2457,375,1146,93,1239,200,en,4.15857,425
297,2982,568,1306,142,1448,200,en,4.18036,426
298,2708,538,1214,134,1348,200,en,4.448181,427
299,10577,1102,3181,275,3456,200,en,7.208779,428
300,385,178,627,44,671,200,en,1.618755,429
301,3006,589,1962,272,2234,200,ru,7.256704,430
302,6297,1060,2105,265,2370,200,en,7.472167,1443
303,77,80,627,37,664,200,ru,1.499149,1644
304,1371,294,1218,134,1352,200,ru,3.979784,431
305,4212,461,1594,115,1709,200,en,5.068976,436
306,940,444,1025,205,1230,200,ru,5.427372,437
307,331,141,743,64,807,200,ru,2.337585,438
308,2255,304,1604,135,1739,200,ru,4.184223,3575
309,1778,211,1395,97,1492,200,ru,2.33699,439
310,4063,853,1552,213,1765,200,en,5.511309,440
311,2381,508,1672,230,1902,200,ru,6.537808,441
312,3982,202,2399,94,2493,200,ru,3.155938,442
313,1304,224,1181,103,1284,200,ru,2.977443,443
314,941,268,1023,119,1142,200,ru,4.274395,444
315,592,132,859,58,917,200,ru,2.202505,450
316,1197,150,1141,69,1210,200,ru,2.350775,451
317,1406,452,1228,207,1435,200,ru,6.43424,452
318,84,91,630,42,672,200,ru,1.558983,1645
319,1443,341,1249,157,1406,200,ru,4.273635,453
320,1124,238,1101,109,1210,200,ru,2.833054,454
321,2056,419,1518,190,1708,200,ru,5.173008,455
322,1215,345,1131,153,1284,200,ru,4.096532,456
323,1770,336,1408,154,1562,200,ru,3.99921,457
324,1377,308,1211,140,1351,200,ru,4.754509,458
325,9281,503,4777,231,5008,200,ru,6.642441,3576
326,1433,308,1244,140,1384,200,ru,3.745302,464
327,562,281,845,125,970,200,ru,3.880083,465
328,1310,362,1189,166,1355,200,ru,4.221255,466
329,1337,331,1196,148,1344,200,ru,3.83293,467
330,928,173,999,76,1075,200,ru,2.849884,468
331,406,156,633,39,672,200,en,1.798914,1444
332,885,380,994,173,1167,200,ru,4.924306,469
333,1978,626,1498,290,1788,200,ru,6.267931,470
334,629,158,880,73,953,200,ru,2.197173,471
335,1210,191,1144,88,1232,200,ru,2.836187,477
336,471,171,804,76,880,200,ru,2.178117,478
337,1238,227,1148,104,1252,200,ru,3.067871,846
338,998,450,1048,205,1253,200,ru,5.99019,479
339,1423,461,1212,207,1419,200,ru,5.594208,480
340,577,181,854,82,936,200,ru,3.15989,481
341,1438,545,1247,245,1492,200,ru,6.444001,482
342,585,279,857,128,985,200,ru,3.870191,483
343,295,136,605,34,639,200,en,1.367518,1445
344,819,204,949,91,1040,200,ru,3.306971,484
345,10518,743,5335,337,5672,200,ru,9.599543,490
346,5078,596,2912,269,3181,200,ru,5.813729,491
347,1782,421,1413,194,1607,200,ru,4.849051,492
348,5186,546,2931,249,3180,200,ru,6.380244,493
349,5111,634,2922,291,3213,200,ru,8.792158,494
350,6866,804,2279,201,2480,200,en,5.566424,1446
351,19089,810,5370,202,5572,200,en,7.085343,1447
352,5675,850,1959,212,2171,200,en,6.148079,1448
353,1858,433,1440,197,1637,200,ru,5.402852,495
354,12518,812,6306,366,6672,200,ru,11.558269,496
355,2858,358,1888,164,2052,200,ru,4.154326,501
356,1318,345,1191,156,1347,200,ru,4.697,502
357,677,219,901,101,1002,200,ru,2.841445,503
358,1233,239,1145,107,1252,200,ru,3.245497,504
359,1211,317,1145,146,1291,200,ru,4.022034,505
360,2229,459,1614,210,1824,200,ru,5.090822,506
361,4135,729,1581,182,1763,200,en,5.100965,1449
362,1616,415,1330,192,1522,200,ru,3.979818,507
363,1776,442,1393,203,1596,200,ru,4.894941,508
364,2242,483,1609,223,1832,200,ru,4.852522,509
365,677,115,899,53,952,200,ru,1.763621,515
366,3037,544,1292,136,1428,200,en,4.238559,516
367,2699,283,1827,129,1956,200,ru,3.940524,517
368,263,92,711,42,753,200,ru,1.407046,518
369,901,127,998,58,1056,200,ru,2.874784,519
370,1206,225,1134,103,1237,200,ru,3.142106,520
371,665,116,898,53,951,200,ru,2.296014,521
372,5538,1196,3125,542,3667,200,ru,15.014654,522
373,1360,399,1204,181,1385,200,ru,4.335519,523
374,2583,343,1753,134,1887,200,ru,5.305461,524
375,971,284,1035,128,1163,200,ru,3.570489,528
376,559,171,843,78,921,200,ru,2.298597,529
377,2050,387,1403,168,1571,200,ru,4.32778,1647
378,12581,806,6193,375,6568,200,ru,9.365518,1648
379,1227,343,1151,157,1308,200,ru,3.784567,530
380,679,272,903,124,1027,200,ru,3.564889,531
381,1041,353,1059,163,1222,200,ru,4.351003,532
382,1159,331,1125,152,1277,200,ru,3.840915,533
383,1572,210,1297,98,1395,200,ru,2.967214,534
384,2362,305,1462,135,1597,200,ru,3.347032,1649
385,664,300,884,129,1013,200,ru,3.810541,538
386,609,265,871,119,990,200,ru,3.523983,539
387,5472,786,1917,196,2113,200,en,5.645268,1697
388,9629,1524,2949,381,3330,200,en,10.500785,1698
389,1714,1020,1374,461,1835,200,ru,11.490221,540
390,636,263,884,120,1004,200,ru,3.201961,541
391,814,174,962,80,1042,200,ru,2.326151,542
392,1532,206,1292,95,1387,200,ru,2.984379,543
393,1546,322,1289,147,1436,200,ru,4.301081,544
394,662,164,892,76,968,200,ru,2.437542,545
395,2807,646,1246,161,1407,200,en,4.67674,1699
396,1454,450,1251,206,1457,200,ru,5.200531,551
397,859,277,971,122,1093,200,ru,4.031491,552
398,1569,437,1318,203,1521,200,ru,5.172675,553
399,1060,401,1068,181,1249,200,ru,5.521145,554
400,1747,333,1376,151,1527,200,ru,3.604568,555
401,2629,506,1196,126,1322,200,en,4.981116,1700
402,1442,176,1252,82,1334,200,ru,2.608247,556
403,1013,248,1058,115,1173,200,ru,3.808896,557
404,1459,484,1258,222,1480,200,ru,5.680035,558
405,1476,347,1243,155,1398,200,ru,3.864776,562
406,1863,488,1397,219,1616,200,ru,5.348556,563
407,1102,399,1095,183,1278,200,ru,4.221758,564
408,1172,254,1130,117,1247,200,ru,3.054256,565
409,1782,458,1406,211,1617,200,ru,5.307976,566
410,531,210,664,52,716,200,en,2.184388,2193
411,1147,254,1114,117,1231,200,ru,2.850988,567
412,1859,365,1435,166,1601,200,ru,4.986318,568
413,1773,660,1409,305,1714,200,ru,6.920117,569
414,1335,281,1199,130,1329,200,ru,3.547401,570
415,978,241,1030,109,1139,200,ru,3.400891,575
416,1681,341,1357,155,1512,200,ru,3.964022,576
417,547,92,832,42,874,200,ru,1.40394,587
418,1210,214,1130,94,1224,200,ru,3.780298,577
419,674,229,891,104,995,200,ru,2.56901,578
420,1873,330,1448,152,1600,200,ru,5.428666,579
421,646,302,888,140,1028,200,ru,4.01224,580
422,806,176,958,78,1036,200,ru,2.596534,581
423,827,177,970,81,1051,200,ru,2.769578,582
424,897,274,999,126,1125,200,ru,3.632546,583
425,1658,198,1339,91,1430,200,ru,3.048781,590
426,1625,237,1324,107,1431,200,ru,2.913147,591
427,945,211,1013,97,1110,200,ru,2.544698,592
428,1421,204,1229,93,1322,200,ru,2.846142,593
429,2421,152,1664,67,1731,200,ru,2.867256,594
430,2097,469,1546,216,1762,200,ru,4.480473,595
431,2122,268,1553,125,1678,200,ru,2.898651,596
432,8794,433,4519,199,4718,200,ru,7.878242,634
433,4432,662,1647,165,1812,200,en,5.285111,635
434,4115,597,1585,149,1734,200,en,5.374405,636
435,2984,127,1941,58,1999,200,ru,2.069894,599
436,2642,577,1780,264,2044,200,ru,5.297896,600
437,1006,230,1033,104,1137,200,ru,2.792708,601
438,3848,670,2337,309,2646,200,ru,8.304282,602
439,1598,243,1317,112,1429,200,ru,3.078185,603
440,4299,535,1620,133,1753,200,en,3.623691,637
441,2859,518,1251,129,1380,200,en,4.658844,638
442,2006,401,1037,100,1137,200,en,3.40958,639
443,1911,473,1461,219,1680,200,ru,5.754204,604
444,1298,352,1169,159,1328,200,ru,5.00489,605
445,3186,310,2050,140,2190,200,ru,5.442154,668
446,1298,490,1169,221,1390,200,ru,6.128694,605
447,2361,517,1640,233,1873,200,ru,6.417814,611
448,1688,269,1354,126,1480,200,ru,3.346015,612
449,1188,226,1117,104,1221,200,ru,3.228582,613
450,1364,310,1207,142,1349,200,ru,4.208736,614
451,1188,373,1132,168,1300,200,ru,4.548703,615
452,1627,391,1337,182,1519,200,ru,4.184853,616
453,1270,247,1168,114,1282,200,ru,2.867348,617
454,617,136,864,60,924,200,ru,1.513533,618
455,939,161,1010,73,1083,200,ru,2.408273,631
456,5659,873,3160,398,3558,200,ru,10.486646,632
457,1157,387,820,96,916,200,en,3.064718,640
458,492,275,811,121,932,200,ru,3.739665,641
459,276,155,714,65,779,200,ru,2.777929,642
460,399,165,769,69,838,200,ru,2.429805,643
461,378,123,765,57,822,200,ru,2.129454,644
462,289,94,720,42,762,200,ru,1.58066,645
463,76,82,626,37,663,200,ru,1.368683,646
464,3740,195,2276,87,2363,200,ru,7.854186,669
465,1094,469,1091,217,1308,200,ru,5.84705,650
466,1004,489,1046,225,1271,200,ru,5.990077,651
467,1660,340,1358,156,1514,200,ru,4.380231,652
468,4976,218,2862,100,2962,200,ru,2.954451,653
469,1493,226,1255,102,1357,200,ru,2.942992,654
470,2846,713,1245,178,1423,200,en,5.11903,671
471,1283,151,1165,69,1234,200,ru,2.980638,655
472,2283,354,1612,164,1776,200,ru,3.534653,656
473,2626,374,1780,165,1945,200,ru,6.157152,658
474,5807,1254,3236,574,3810,200,ru,14.293063,659
475,2283,285,1612,131,1743,200,ru,3.759216,656
476,2626,350,1780,157,1937,200,ru,4.792606,658
477,5807,1177,3236,538,3774,200,ru,12.423418,659
478,1781,379,978,94,1072,200,en,2.909253,677
479,12353,782,3628,195,3823,200,en,6.117493,678
480,3385,509,1378,127,1505,200,en,5.122524,679
481,4838,721,1745,180,1925,200,en,5.15013,680
482,1719,457,960,114,1074,200,en,4.316335,681
483,1583,563,927,140,1067,200,en,4.118862,682
484,1733,324,1372,148,1520,200,ru,3.450952,703
485,5484,534,1905,133,2038,200,en,5.203057,687
486,8270,626,2599,156,2755,200,en,5.2336,688
487,2459,549,1152,137,1289,200,en,4.148408,689
488,3727,567,1497,141,1638,200,en,4.774311,690
489,3163,722,1323,180,1503,200,en,5.543736,691
490,6832,617,2269,154,2423,200,en,4.938185,692
491,2371,611,1142,152,1294,200,en,4.306568,693
492,2359,519,1122,129,1251,200,en,4.362895,694
493,2016,383,1511,178,1689,200,ru,4.417764,697
494,1485,113,1261,51,1312,200,ru,2.174967,698
495,1046,214,1061,99,1160,200,ru,2.45053,705
496,1389,262,1225,122,1347,200,ru,4.165353,706
497,1350,388,1189,174,1363,200,ru,4.922659,707
498,975,198,1028,90,1118,200,ru,2.425538,708
499,374,130,757,59,816,200,ru,1.828055,2381
500,807,126,945,56,1001,200,ru,1.979314,709
501,1973,485,1478,222,1700,200,ru,5.323108,710
502,1201,191,1139,89,1228,200,ru,2.572441,711
503,1697,281,1367,131,1498,200,ru,3.605895,712
504,1714,303,1364,140,1504,200,ru,4.351498,713
505,3402,570,2133,264,2397,200,ru,7.532158,717
506,1416,369,1245,170,1415,200,ru,4.565005,718
507,1295,147,1177,67,1244,200,ru,2.603428,852
508,1315,525,1188,240,1428,200,ru,5.594549,719
509,6565,714,2181,178,2359,200,en,4.740148,720
510,2846,545,1245,136,1381,200,en,3.852516,721
511,3797,526,1489,131,1620,200,en,4.735742,722
512,2801,610,1235,152,1387,200,en,4.706393,723
513,5920,858,2022,214,2236,200,en,6.049015,724
514,2679,451,1217,112,1329,200,en,4.285191,725
515,2665,431,1801,195,1996,200,ru,5.964899,731
516,2667,401,1782,182,1964,200,ru,5.050833,732
517,1632,395,1322,178,1500,200,ru,4.344644,733
518,2020,186,1502,87,1589,200,ru,2.936534,734
519,5987,485,2029,121,2150,200,en,4.200236,869
520,5479,696,1902,174,2076,200,en,5.064854,870
521,6057,973,2043,243,2286,200,en,7.554449,871
522,1752,445,1388,204,1592,200,ru,4.263218,735
523,2571,607,1752,278,2030,200,ru,7.178602,736
524,1642,412,1310,180,1490,200,ru,6.323317,737
525,2143,126,1559,57,1616,200,ru,2.409647,742
526,2393,466,1671,212,1883,200,ru,4.916078,743
527,1269,201,1164,92,1256,200,ru,3.029378,744
528,1069,221,1068,97,1165,200,ru,2.670882,745
529,2420,607,1687,279,1966,200,ru,6.629917,746
530,1403,196,1221,88,1309,200,ru,2.270445,747
531,1607,628,1302,286,1588,200,ru,10.178111,748
532,1657,480,1322,215,1537,200,ru,5.911959,749
533,2675,449,1801,206,2007,200,ru,4.721764,750
534,2262,419,1606,192,1798,200,ru,4.330382,751
535,2099,594,1536,271,1807,200,ru,7.230882,754
536,1945,325,1460,145,1605,200,ru,4.572536,755
537,2396,442,1678,202,1880,200,ru,5.625281,756
538,1495,427,1270,199,1469,200,ru,4.896188,757
539,2910,446,1915,206,2121,200,ru,4.308072,758
540,2273,396,1594,176,1770,200,ru,5.047981,759
541,1909,339,1449,152,1601,200,ru,4.040409,760
542,2283,291,1629,133,1762,200,ru,3.811168,761
543,1988,273,1479,124,1603,200,ru,3.459137,762
544,3164,510,2009,230,2239,200,ru,8.238132,763
545,695,181,907,81,988,200,ru,2.53394,768
546,913,156,998,71,1069,200,ru,2.242471,769
547,1408,383,1240,176,1416,200,ru,4.542302,770
548,2286,421,1632,195,1827,200,ru,4.718557,771
549,2063,410,1525,186,1711,200,ru,5.082567,772
550,412,157,778,72,850,200,ru,2.281378,1734
551,1144,247,1116,113,1229,200,ru,3.937139,773
552,1718,460,1371,213,1584,200,ru,5.237241,774
553,541,350,836,159,995,200,ru,3.76339,775
554,801,107,955,49,1004,200,ru,1.969529,776
555,1154,321,1111,147,1258,200,ru,3.018058,780
556,3014,437,1949,202,2151,200,ru,4.496883,781
557,935,395,1017,182,1199,200,ru,4.928463,782
558,1833,418,1417,191,1608,200,ru,4.994143,783
559,1251,365,1153,168,1321,200,ru,3.669159,812
560,1213,288,1141,128,1269,200,ru,3.898682,784
561,4322,763,1611,190,1801,200,en,5.29962,785
562,5763,859,1978,214,2192,200,en,5.602681,786
563,5325,735,1862,183,2045,200,en,5.30127,787
564,6547,870,2167,217,2384,200,en,5.679958,788
565,1247,564,1160,259,1419,200,ru,6.221025,803
566,4322,708,1611,177,1788,200,en,5.183973,785
567,5325,759,1862,189,2051,200,en,4.730086,787
568,2283,570,1101,142,1243,200,en,4.212229,797
569,815,201,734,50,784,200,en,2.51306,798
570,4903,713,1761,178,1939,200,en,5.724533,799
571,2401,597,1130,149,1279,200,en,4.502885,800
572,5703,816,1960,204,2164,200,en,5.143795,801
573,889,201,991,92,1083,200,ru,2.518728,802
574,536,126,830,57,887,200,ru,2.206647,818
575,4621,806,1704,201,1905,200,en,6.600633,808
576,1790,236,1400,106,1506,200,ru,4.319544,809
577,2916,533,1272,133,1405,200,en,4.005543,810
578,1576,311,1301,140,1441,200,ru,3.973507,811
579,1837,625,1439,291,1730,200,ru,6.910973,813
580,606,92,867,41,908,200,ru,2.002312,814
581,1282,483,1175,221,1396,200,ru,5.930493,815
582,1074,307,1083,142,1225,200,ru,3.573521,816
583,687,282,904,128,1032,200,ru,3.906215,817
584,6290,456,3412,208,3620,200,ru,4.917215,820
585,1145,124,1097,55,1152,200,ru,1.881038,828
586,2366,550,1128,137,1265,200,en,5.480765,829
587,20963,1801,5773,450,6223,200,en,15.792127,830
588,2715,523,1229,130,1359,200,en,4.926963,831
589,2096,608,1531,273,1804,200,ru,8.772763,1735
590,6081,347,3320,152,3472,200,ru,6.276631,1736
591,2356,444,1122,111,1233,200,en,3.987522,832
592,679,323,901,146,1047,200,ru,4.538509,833
593,1009,488,1054,227,1281,200,ru,5.158482,834
594,1947,342,1490,156,1646,200,ru,4.103884,835
595,1408,386,881,96,977,200,en,3.946478,840
596,4010,656,1534,164,1698,200,en,6.851635,841
597,604,170,870,79,949,200,ru,2.300553,842
598,3782,631,1477,157,1634,200,en,3.913715,843
599,1157,345,821,86,907,200,en,2.596362,844
600,1125,463,1106,214,1320,200,ru,5.254648,845
601,682,181,896,82,978,200,ru,2.455499,847
602,1163,354,1105,162,1267,200,ru,3.887685,848
603,1092,425,1085,192,1277,200,ru,5.023736,849
604,637,247,881,115,996,200,ru,2.803861,850
605,1764,187,1385,86,1471,200,ru,2.738376,857
606,1375,354,1229,166,1395,200,ru,4.127204,875
607,4741,882,1727,220,1947,200,en,5.404665,2326
608,2543,481,1738,222,1960,200,ru,6.494044,858
609,1605,101,1315,46,1361,200,ru,1.744888,859
610,1881,540,1445,241,1686,200,ru,7.161912,860
611,5251,679,2923,304,3227,200,ru,8.713016,861
612,3240,457,1342,114,1456,200,en,4.132699,862
613,2667,479,1197,119,1316,200,en,3.910627,863
614,8167,614,2575,153,2728,200,en,4.991189,864
615,592,130,863,59,922,200,ru,2.030293,876
616,620,120,869,52,921,200,ru,1.881505,877
617,1185,200,1130,91,1221,200,ru,2.616167,878
618,1213,419,1132,187,1319,200,ru,5.385169,879
619,517,201,826,93,919,200,ru,2.3665,880
620,633,95,877,44,921,200,ru,1.447967,888
621,760,102,932,46,978,200,ru,1.793286,881
622,2550,494,1750,227,1977,200,ru,5.529426,882
623,1375,262,1218,121,1339,200,ru,3.180176,883
624,350,125,748,58,806,200,ru,1.872506,884
625,1437,610,1245,281,1526,200,ru,5.934057,890
626,742,280,922,124,1046,200,ru,3.831853,891
627,1948,291,1482,134,1616,200,ru,3.519566,892
628,1189,355,1120,159,1279,200,ru,5.580811,893
629,1118,269,1084,110,1194,200,ru,4.231797,894
630,724,269,910,120,1030,200,ru,3.223812,895
631,1460,140,1254,63,1317,200,ru,2.313567,896
632,576,236,857,110,967,200,ru,3.1738,897
633,1928,277,1483,129,1612,200,ru,3.418557,898
634,452,291,644,72,716,200,en,2.779155,3369
635,1322,450,1194,205,1399,200,ru,5.21503,905
636,1783,336,1416,156,1572,200,ru,4.378632,906
637,529,187,834,84,918,200,ru,2.917933,907
638,7426,768,3971,350,4321,200,ru,9.606845,908
639,860,236,983,109,1092,200,ru,2.901175,909
640,737,139,926,62,988,200,ru,1.88821,910
641,1317,367,1192,168,1360,200,ru,4.357919,911
642,1163,320,1121,147,1268,200,ru,4.005601,912
643,935,268,1020,123,1143,200,ru,4.060383,913
644,763,93,931,41,972,200,ru,1.393194,914
645,3496,477,2186,220,2406,200,ru,5.040191,919
646,1360,311,1196,139,1335,200,ru,4.736482,920
647,1272,290,1167,132,1299,200,ru,4.250825,922
648,960,259,1027,119,1146,200,ru,3.621008,923
649,451,93,799,42,841,200,ru,2.167621,924
650,1514,281,1281,129,1410,200,ru,3.327095,925
651,1327,398,1200,183,1383,200,ru,4.756182,926
652,623,309,686,77,763,200,en,2.644569,2410
653,681,233,905,108,1013,200,ru,3.156216,927
654,1218,417,1144,191,1335,200,ru,5.406199,928
655,2140,546,1562,250,1812,200,ru,6.027023,935
656,828,201,961,91,1052,200,ru,3.541563,936
657,2090,331,1526,147,1673,200,ru,4.72151,937
658,1277,411,1174,192,1366,200,ru,4.198559,938
659,610,236,867,107,974,200,ru,3.520915,939
660,2023,316,1528,146,1674,200,ru,4.706273,940
661,614,164,871,76,947,200,ru,3.002987,941
662,3717,580,2282,268,2550,200,ru,6.772243,942
663,104,238,639,111,750,200,ru,3.517192,943
664,806,147,958,67,1025,200,ru,1.993577,944
665,12478,749,6286,347,6633,200,ru,6.853004,1754
666,10458,718,5419,333,5752,200,ru,8.225783,1755
667,880,158,995,74,1069,200,ru,2.543948,950
668,1677,122,1355,54,1409,200,ru,1.951842,951
669,2464,461,1641,206,1847,200,ru,5.667656,952
670,1045,479,1066,217,1283,200,ru,5.632162,953
671,1405,470,1243,219,1462,200,ru,4.709186,959
672,788,273,940,121,1061,200,ru,4.263263,954
673,1229,294,1160,136,1296,200,ru,3.291843,955
674,1304,633,1190,293,1483,200,ru,9.092929,956
675,676,310,903,142,1045,200,ru,3.988267,963
676,2021,683,1504,310,1814,200,ru,7.302919,964
677,2004,879,1504,401,1905,200,ru,8.320929,965
678,1957,604,1488,278,1766,200,ru,6.00248,971
679,1982,493,1502,226,1728,200,ru,5.783004,966
680,2032,368,1528,171,1699,200,ru,5.373026,967
681,813,357,950,148,1098,200,ru,4.243429,968
682,2058,468,1510,211,1721,200,ru,5.477085,969
683,10958,622,5545,284,5829,200,ru,7.727486,970
684,1498,279,1282,127,1409,200,ru,3.412748,976
685,1938,578,1476,261,1737,200,ru,6.368271,978
686,5822,756,1988,189,2177,200,en,5.505049,979
687,3058,498,1314,124,1438,200,en,5.086931,981
688,2907,568,1270,142,1412,200,en,4.106705,982
689,4941,622,1780,155,1935,200,en,5.814737,983
690,3401,625,1396,156,1552,200,en,4.437367,984
691,1563,391,1307,179,1486,200,ru,5.80136,985
692,2837,317,1862,143,2005,200,ru,3.957443,1066
693,281,173,720,79,799,200,ru,2.099232,1765
694,553,170,846,79,925,200,ru,2.392388,986
695,1286,247,1178,113,1291,200,ru,4.107869,1000
696,3304,564,1368,141,1509,200,en,5.318391,1002
697,4899,842,1764,210,1974,200,en,6.195711,1003
698,1845,282,1423,131,1554,200,ru,4.414281,1004
699,1525,245,1280,112,1392,200,ru,3.185992,1005
700,3287,449,2090,206,2296,200,ru,5.184547,1006
701,2032,385,1511,178,1689,200,ru,3.699518,1007
702,3056,520,1978,241,2219,200,ru,6.170308,1008
703,1517,82,1270,38,1308,200,ru,1.913218,1009
704,1521,184,1279,85,1364,200,ru,2.687149,1010
705,1521,163,1279,76,1355,200,ru,2.278253,1010
706,994,151,1027,69,1096,200,ru,2.033002,1013
707,1507,218,1277,100,1377,200,ru,2.867113,1014
708,2005,444,1496,204,1700,200,ru,5.020605,1015
709,1912,260,1453,119,1572,200,ru,2.927505,1016
710,6973,1003,2297,250,2547,200,en,6.403581,1115
711,4004,890,1553,222,1775,200,en,7.101616,1116
712,7211,895,2365,223,2588,200,en,6.837804,1117
713,1977,205,1485,93,1578,200,ru,2.825841,1017
714,3114,635,2004,292,2296,200,ru,6.57587,1018
715,4522,640,1666,160,1826,200,en,5.078037,1118
716,4138,679,1582,169,1751,200,en,4.630143,1119
717,3114,632,2004,290,2294,200,ru,7.015169,1018
718,1624,375,1323,172,1495,200,ru,4.246685,1022
719,837,257,964,119,1083,200,ru,3.093038,1023
720,2045,390,1511,175,1686,200,ru,5.319053,1024
721,1097,290,1083,134,1217,200,ru,3.421944,1025
722,995,210,1039,96,1135,200,ru,2.901893,1026
723,769,174,911,72,983,200,ru,2.246026,1027
724,1469,233,1255,108,1363,200,ru,3.087334,1028
725,2715,411,1215,102,1317,200,en,4.068222,1134
726,2873,606,1250,151,1401,200,en,4.694846,1135
727,3294,853,1354,213,1567,200,en,5.510487,1136
728,1995,493,1031,123,1154,200,en,3.649454,1033
729,4614,879,1684,219,1903,200,en,6.208056,1034
730,1546,454,917,113,1030,200,en,4.045429,1035
731,2423,559,1136,139,1275,200,en,4.333972,1036
732,1105,331,807,82,889,200,en,3.195096,1037
733,9782,857,2988,214,3202,200,en,6.088404,1137
734,3898,724,1524,181,1705,200,en,5.552644,1138
735,3715,639,1458,159,1617,200,en,4.867367,1039
736,5900,904,2065,226,2291,200,en,5.884739,1040
737,6845,663,2260,165,2425,200,en,5.464153,1041
738,13881,962,4045,240,4285,200,en,6.067463,1042
739,484,319,652,79,731,200,en,2.308619,1043
740,4797,911,1758,227,1985,200,en,6.083895,1044
741,6374,814,2161,203,2364,200,en,6.07657,1045
742,807,313,736,78,814,200,en,2.451207,1046
743,2949,699,1814,305,2119,200,ru,8.037891,1047
744,1500,548,1271,248,1519,200,ru,6.539924,1048
745,1768,213,1385,95,1480,200,ru,2.827856,1054
746,2320,534,1642,249,1891,200,ru,5.749019,1055
747,1783,592,1392,273,1665,200,ru,6.762917,1056
748,872,203,977,92,1069,200,ru,3.603203,1057
749,3817,393,2349,176,2525,200,ru,5.269355,2431
750,931,209,1009,92,1101,200,ru,3.371099,1060
751,900,290,993,133,1126,200,ru,4.172698,1061
752,1446,544,1239,247,1486,200,ru,5.222114,1062
753,1390,208,1215,90,1305,200,ru,4.271929,1063
754,1942,370,1463,166,1629,200,ru,5.319259,1064
755,2165,185,1569,85,1654,200,ru,2.685974,1069
756,2643,529,1790,243,2033,200,ru,6.205391,1070
757,2414,438,1678,203,1881,200,ru,4.933636,1071
758,1965,553,1483,257,1740,200,ru,6.901498,1072
759,2087,344,1535,158,1693,200,ru,5.331425,159
760,1775,191,1391,88,1479,200,ru,2.866352,1073
761,1328,112,1194,52,1246,200,ru,1.583192,1074
762,2269,401,1610,185,1795,200,ru,4.252177,1075
763,1250,133,1153,61,1214,200,ru,1.913877,1076
764,1598,250,1313,114,1427,200,ru,2.971085,1077
765,1649,159,1343,73,1416,200,ru,2.23375,1082
766,2146,478,1572,217,1789,200,ru,4.820436,338
767,1769,533,1388,245,1633,200,ru,5.345699,1083
768,1865,346,1437,159,1596,200,ru,4.736097,1084
769,1696,529,1373,243,1616,200,ru,5.347308,1085
770,2246,354,1625,162,1787,200,ru,3.990227,1086
771,1408,420,1240,194,1434,200,ru,4.06049,1087
772,1343,408,1195,185,1380,200,ru,4.736914,1165
773,1977,286,1498,128,1626,200,ru,3.776377,1088
774,1014,201,1045,88,1133,200,ru,3.174829,1089
775,3725,344,2297,154,2451,200,ru,4.819209,1094
776,4008,454,2416,206,2622,200,ru,6.694999,1095
777,4818,205,2788,91,2879,200,ru,3.297765,1096
778,4752,491,2719,221,2940,200,ru,7.600289,1097
779,4276,676,2464,309,2773,200,ru,9.256252,1098
780,1014,183,1045,81,1126,200,ru,3.060804,1089
781,912,221,1003,99,1102,200,ru,4.896505,1101
782,5095,345,2907,154,3061,200,ru,5.284438,1102
783,3605,489,2227,223,2450,200,ru,5.448162,1103
784,3203,533,1349,133,1482,200,en,3.919111,1104
785,5138,535,1833,133,1966,200,en,4.1662,1112
786,326,140,612,35,647,200,en,1.664428,1113
787,1560,467,923,116,1039,200,en,3.617959,1114
788,5095,229,2907,103,3010,200,ru,3.506277,1102
789,3203,764,1349,191,1540,200,en,5.404733,1104
790,1662,353,950,88,1038,200,en,2.905071,1120
791,5178,787,1859,197,2056,200,en,7.836273,1121
792,3566,568,1432,142,1574,200,en,4.391986,1122
793,2138,492,1070,123,1193,200,en,3.899853,1123
794,9793,783,3013,195,3208,200,en,6.104397,1124
795,6591,951,2207,237,2444,200,en,6.400485,1131
796,5178,791,1859,198,2057,200,en,6.229622,1121
797,3566,590,1432,148,1580,200,en,4.954217,1122
798,9793,815,3013,203,3216,200,en,5.995681,1124
799,2015,521,1044,130,1174,200,en,4.442869,1140
800,2413,486,1139,121,1260,200,en,4.078118,1141
801,933,319,767,79,846,200,en,2.805248,1142
802,940,287,772,71,843,200,en,2.361155,1143
803,901,381,756,95,851,200,en,3.298271,1144
804,1046,213,792,53,845,200,en,2.12355,1145
805,2445,437,1144,109,1253,200,en,5.922672,1150
806,1229,153,1145,68,1213,200,ru,3.352278,1151
807,589,252,679,63,742,200,en,2.590512,3381
808,807,185,954,85,1039,200,ru,2.750682,1152
809,4756,668,1733,167,1900,200,en,5.227071,1153
810,925,368,1002,167,1169,200,ru,4.499316,1154
811,834,158,967,71,1038,200,ru,1.925704,1155
812,2125,320,1567,148,1715,200,ru,3.823698,1156
813,583,137,857,63,920,200,ru,1.62003,1157
814,3055,679,1309,169,1478,200,en,4.759981,1159
815,3055,678,1309,169,1478,200,en,4.873003,1159
816,1633,365,939,91,1030,200,en,2.980042,1166
817,990,486,779,121,900,200,en,3.632649,1167
818,2462,538,1706,245,1951,200,ru,8.31856,1168
819,4377,797,1626,199,1825,200,en,5.723379,1169
820,3706,595,1457,148,1605,200,en,3.826869,1170
821,1049,346,793,86,879,200,en,2.794813,1171
822,2987,546,1278,136,1414,200,en,4.724509,1172
823,2579,508,1176,127,1303,200,en,4.107713,1173
824,1132,339,1104,155,1259,200,ru,4.920156,1174
825,1059,217,1072,99,1171,200,ru,2.715888,1179
826,1297,332,1176,151,1327,200,ru,3.95159,1180
827,170,162,574,40,614,200,en,1.610681,3383
828,587,73,853,33,886,200,ru,1.746683,1181
829,952,150,1014,66,1080,200,ru,2.040135,1182
830,1138,340,1100,150,1250,200,ru,5.030409,1183
831,865,140,977,63,1040,200,ru,2.032233,1184
832,3324,629,1372,157,1529,200,en,3.638152,1185
833,84,47,552,11,563,200,en,0.82577,1186
834,2681,483,1200,120,1320,200,en,3.819348,1187
835,498,318,656,79,735,200,en,4.092962,1192
836,1924,604,1013,151,1164,200,en,4.707624,1193
837,1883,524,1002,131,1133,200,en,3.678708,1194
838,982,406,776,101,877,200,en,3.079549,1488
839,1970,536,1023,134,1157,200,en,4.038592,1195
840,4067,700,1565,175,1740,200,en,6.055901,1196
841,3058,562,1310,140,1450,200,en,4.482922,1197
842,2965,545,1284,136,1420,200,en,4.073896,1198
843,3166,543,1331,135,1466,200,en,4.437516,1199
844,3724,572,1468,143,1611,200,en,5.45135,1200
845,4067,549,1565,137,1702,200,en,5.027657,1196
846,3058,555,1310,138,1448,200,en,4.589479,1197
847,3724,474,1468,118,1586,200,en,5.034165,1200
848,946,430,1025,198,1223,200,ru,6.183948,1208
849,1310,518,1195,240,1435,200,ru,6.129582,1209
850,857,372,981,171,1152,200,ru,5.329101,1210
851,1039,402,1066,182,1248,200,ru,4.935814,1211
852,1002,86,1039,39,1078,200,ru,1.768782,1217
853,7060,815,3803,368,4171,200,ru,8.995409,1523
854,1752,597,1372,277,1649,200,ru,8.758651,1212
855,2732,630,1214,157,1371,200,en,5.112074,1218
856,1908,481,1446,216,1662,200,ru,5.401169,1219
857,3440,448,2130,203,2333,200,ru,4.907903,1220
858,1955,443,1487,207,1694,200,ru,5.448913,1221
859,2054,441,1494,192,1686,200,ru,4.426249,1222
860,2433,487,1641,201,1842,200,ru,7.274228,1524
861,1151,304,1117,141,1258,200,ru,3.785703,1223
862,3702,730,2254,333,2587,200,ru,9.597319,1226
863,3382,480,2119,219,2338,200,ru,5.733744,1227
864,3520,660,2196,304,2500,200,ru,7.633996,1228
865,572,156,839,66,905,200,ru,3.252178,1234
866,2239,602,1613,277,1890,200,ru,6.402623,1525
867,3561,539,1421,134,1555,200,en,3.842362,3386
868,3702,734,2254,335,2589,200,ru,9.601003,1226
869,849,283,975,130,1105,200,ru,3.309218,1235
870,1384,230,1215,105,1320,200,ru,3.63708,1236
871,567,342,850,156,1006,200,ru,3.936661,1237
872,4072,677,2457,312,2769,200,ru,6.871897,1238
873,1094,337,1091,156,1247,200,ru,3.786136,1239
874,6796,285,3644,128,3772,200,ru,5.627378,1240
875,1966,469,1479,215,1694,200,ru,6.456372,1245
876,1454,297,1237,134,1371,200,ru,3.928893,1246
877,1541,279,1287,128,1415,200,ru,3.290588,1247
878,999,84,1025,37,1062,200,ru,1.459903,1248
879,1664,278,1337,127,1464,200,ru,3.818671,1249
880,2548,394,1752,183,1935,200,ru,4.440543,1250
881,2539,364,1743,167,1910,200,ru,4.857131,1251
882,2338,79,1647,37,1684,200,ru,1.329981,1252
883,1407,222,1229,102,1331,200,ru,2.845494,1253
884,766,277,723,69,792,200,en,2.814956,1276
885,7526,1066,2440,266,2706,200,en,6.659608,1258
886,5675,850,1959,212,2171,200,en,6.130454,1259
887,1404,506,1237,235,1472,200,ru,6.170424,1261
888,1013,141,1053,64,1117,200,ru,1.855952,1262
889,3266,668,1347,167,1514,200,en,5.413365,1277
890,999,147,1050,68,1118,200,ru,2.180738,1263
891,1622,228,1338,106,1444,200,ru,3.041856,1264
892,1371,274,1207,121,1328,200,ru,4.119811,1265
893,571,138,852,64,916,200,ru,1.729282,1266
894,2987,578,1966,264,2230,200,ru,8.156069,1267
895,2422,463,1141,115,1256,200,en,3.299502,1271
896,1979,379,1026,94,1120,200,en,3.196362,1272
897,1532,370,918,92,1010,200,en,2.679198,1273
898,2522,721,1162,180,1342,200,en,5.493866,1278
899,3554,603,1419,150,1569,200,en,3.978309,1279
900,1512,260,1265,117,1382,200,ru,3.289545,1280
901,1713,183,1367,81,1448,200,ru,2.949942,1281
902,197,169,679,73,752,200,ru,2.62224,1282
903,13479,795,6520,354,6874,200,ru,9.164099,1283
904,6409,648,3493,274,3767,200,ru,14.056477,1284
905,830,304,963,135,1098,200,ru,4.044114,1290
906,1974,688,1492,316,1808,200,ru,6.869338,1291
907,3398,386,2156,177,2333,200,ru,4.196733,1292
908,930,361,763,90,853,200,en,2.908568,1296
909,751,373,718,93,811,200,en,2.447301,1321
910,2233,403,1607,182,1789,200,ru,4.533912,1297
911,2009,457,1498,208,1706,200,ru,6.288577,1298
912,1658,252,1339,115,1454,200,ru,3.483024,1299
913,1633,251,1329,115,1444,200,ru,3.387409,1300
914,1013,206,1046,94,1140,200,ru,2.678594,1301
915,745,313,923,140,1063,200,ru,4.170887,1306
916,1666,420,1346,194,1540,200,ru,5.110302,1307
917,2063,393,1525,179,1704,200,ru,5.337477,1308
918,978,249,1024,112,1136,200,ru,3.813438,1309
919,1835,254,1410,115,1525,200,ru,2.908211,1310
920,1539,378,1280,170,1450,200,ru,5.071504,1311
921,2510,586,1158,146,1304,200,en,3.724219,1313
922,4615,723,1699,180,1879,200,en,5.934529,1314
923,375,244,756,109,865,200,ru,3.65805,1316
924,1313,443,1184,203,1387,200,ru,6.119379,1317
925,1313,331,1184,151,1335,200,ru,4.854482,1317
926,1532,389,918,97,1015,200,en,3.599085,1322
927,1443,131,1235,61,1296,200,ru,1.782653,1323
928,1121,525,1106,242,1348,200,ru,6.7162,1324
929,2698,516,1209,129,1338,200,en,5.090123,1325
930,2524,703,1163,175,1338,200,en,5.379302,1326
931,8111,865,2574,216,2790,200,en,6.904443,1327
932,2528,438,1739,196,1935,200,ru,4.951371,1328
933,573,201,675,50,725,200,en,2.02467,2332
934,1258,109,1148,50,1198,200,ru,1.603514,1329
935,1335,412,1207,190,1397,200,ru,4.814511,1340
936,3671,491,2248,222,2470,200,ru,5.096448,1341
937,931,193,1005,85,1090,200,ru,2.99744,1334
938,1532,428,918,107,1025,200,en,3.021018,1335
939,3266,668,1347,167,1514,200,en,5.041958,1336
940,7385,1087,2400,271,2671,200,en,7.976402,1337
941,978,143,1034,65,1099,200,ru,2.031339,1338
942,1545,469,1304,216,1520,200,ru,5.413605,1339
943,8666,617,4539,280,4819,200,ru,8.112146,1342
944,1599,215,1317,95,1412,200,ru,3.150185,1343
945,2916,549,1916,252,2168,200,ru,5.885222,1358
946,2799,593,1719,262,1981,200,ru,6.746913,2333
947,1247,270,1138,113,1251,200,ru,4.336912,1348
948,495,133,812,57,869,200,ru,1.873578,1349
949,1653,438,1342,201,1543,200,ru,6.056322,1350
950,1567,373,1296,170,1466,200,ru,3.985544,1351
951,1185,427,1133,195,1328,200,ru,5.129681,1352
952,257,153,703,68,771,200,ru,1.905551,2341
953,2760,350,1837,160,1997,200,ru,3.977653,2342
954,2080,581,1534,270,1804,200,ru,6.900223,1353
955,1410,590,1241,274,1515,200,ru,5.896224,1359
956,1848,427,1438,196,1634,200,ru,4.771552,1360
957,1080,304,1082,140,1222,200,ru,3.517978,1361
958,1163,274,1114,121,1235,200,ru,3.705466,1362
959,813,168,960,76,1036,200,ru,2.200452,1363
960,1658,318,1339,144,1483,200,ru,4.061147,1364
961,1837,499,1431,225,1656,200,ru,5.966525,1365
962,527,109,828,48,876,200,ru,2.075691,1366
963,1480,299,1245,131,1376,200,ru,3.618322,1367
964,1248,482,1157,218,1375,200,ru,5.601773,1368
965,2057,537,1533,249,1782,200,ru,5.597111,1372
966,643,65,881,30,911,200,ru,1.602943,1373
967,942,198,1022,90,1112,200,ru,2.70633,1374
968,134,103,653,48,701,200,ru,1.654444,1375
969,3227,420,2066,194,2260,200,ru,4.656906,1376
970,2075,396,1527,181,1708,200,ru,5.374204,1377
971,1181,180,1128,81,1209,200,ru,2.843876,1378
972,916,159,1015,73,1088,200,ru,2.697592,1379
973,419,151,774,68,842,200,ru,2.247812,1380
974,696,155,901,69,970,200,ru,2.4588,1381
975,634,237,883,110,993,200,ru,2.913808,1387
976,1080,199,1085,92,1177,200,ru,3.222072,1388
977,1571,100,1310,45,1355,200,ru,1.821804,1389
978,8095,540,4277,247,4524,200,ru,7.024995,1390
979,773,92,941,41,982,200,ru,1.458998,1391
980,1240,321,1158,145,1303,200,ru,5.060171,1392
981,935,198,1019,91,1110,200,ru,2.197354,1393
982,469,145,806,67,873,200,ru,2.577386,1394
983,585,72,855,31,886,200,ru,1.670426,1395
984,2093,393,1536,180,1716,200,ru,4.515929,1396
985,969,267,776,66,842,200,en,2.898302,1402
986,2368,518,1139,129,1268,200,en,4.508471,1403
987,1786,433,977,108,1085,200,en,3.058971,1404
988,2609,559,1183,139,1322,200,en,4.358321,1405
989,4822,699,1736,174,1910,200,en,5.356583,1406
990,3290,766,1353,191,1544,200,en,6.006637,1407
991,1540,460,916,115,1031,200,en,4.040417,1408
992,3512,707,1430,176,1606,200,en,5.521279,1409
993,1091,278,1091,129,1220,200,ru,3.602481,1419
994,854,110,978,47,1025,200,ru,2.362122,1410
995,269,185,599,46,645,200,en,1.975263,1431
996,2090,281,1547,131,1678,200,ru,3.59144,1414
997,1693,282,1372,125,1497,200,ru,3.73733,1415
998,2328,522,1657,235,1892,200,ru,7.037508,1416
999,1229,378,1149,173,1322,200,ru,4.028519,1417
1000,2276,543,1629,249,1878,200,ru,5.473597,1418
1001,356,249,621,62,683,200,en,1.921767,1432
1002,42856,1954,11242,488,11730,200,en,16.031558,1433
1003,1591,583,1320,268,1588,200,ru,5.540145,1420
1004,1349,260,1206,118,1324,200,ru,3.463288,1421
1005,440,233,641,58,699,200,en,2.566551,1434
1006,326,148,613,37,650,200,en,1.269364,1435
1007,1349,263,1206,119,1325,200,ru,3.146108,1421
1008,1740,445,1380,205,1585,200,ru,5.4452,1425
1009,1125,252,1106,116,1222,200,ru,3.482512,1426
1010,2019,194,1515,90,1605,200,ru,2.413035,1427
1011,1026,142,1052,64,1116,200,ru,2.042818,1428
1012,1129,405,813,101,914,200,en,3.038052,1429
1013,2471,664,1150,166,1316,200,en,5.789885,1450
1014,2509,656,1158,164,1322,200,en,4.944319,1451
1015,2300,566,1121,141,1262,200,en,4.632671,1454
1016,3342,748,1368,187,1555,200,en,5.547092,1455
1017,910,362,762,90,852,200,en,3.183663,1456
1018,491,393,653,98,751,200,en,2.585013,1457
1019,453,343,644,85,729,200,en,2.511398,1458
1020,486,200,654,50,704,200,en,1.87378,1459
1021,304,165,606,41,647,200,en,1.814505,1460
1022,2471,663,1150,165,1315,200,en,4.641376,1450
1023,2509,656,1158,164,1322,200,en,4.428,1451
1024,1588,187,1299,85,1384,200,ru,2.564113,1461
1025,1597,412,1318,191,1509,200,ru,5.736086,1462
1026,2700,273,1809,125,1934,200,ru,3.17645,1463
1027,4031,418,2449,195,2644,200,ru,4.508728,1464
1028,2050,127,1517,58,1575,200,ru,2.38305,1465
1029,1471,170,1250,77,1327,200,ru,2.483473,1466
1030,1070,71,1073,33,1106,200,ru,1.326972,1467
1031,1665,260,1320,111,1431,200,ru,4.108664,1469
1032,1686,376,1352,170,1522,200,ru,4.573852,1470
1033,1775,465,1380,211,1591,200,ru,5.435593,1471
1034,1985,528,1492,243,1735,200,ru,6.861176,1472
1035,1985,318,1492,145,1637,200,ru,4.040496,1472
1036,1954,368,1452,166,1618,200,ru,5.196332,1473
1037,1888,273,1447,124,1571,200,ru,3.39835,1474
1038,1270,226,1164,103,1267,200,ru,3.093969,1475
1039,3014,477,1962,219,2181,200,ru,5.869592,1476
1040,1393,204,1222,95,1317,200,ru,2.573539,1477
1041,1358,251,1203,117,1320,200,ru,3.208447,1478
1042,2002,406,1502,188,1690,200,ru,4.653197,1480
1043,257,82,703,34,737,200,ru,1.680502,1481
1044,1591,416,1312,190,1502,200,ru,5.856887,1482
1045,1197,252,1139,120,1259,200,ru,2.378294,1484
1046,2679,616,1200,154,1354,200,en,3.912787,1485
1047,1892,404,1004,101,1105,200,en,3.723018,1486
1048,3122,594,1327,148,1475,200,en,6.335377,1487
1049,257,70,703,30,733,200,ru,1.384896,1481
1050,2673,386,1201,96,1297,200,en,2.937612,1489
1051,4730,752,1726,188,1914,200,en,5.424485,1490
1052,7718,1700,2462,425,2887,200,en,12.20476,1491
1053,5958,905,2042,226,2268,200,en,5.574982,1492
1054,3854,618,1515,154,1669,200,en,4.696781,1493
1055,2838,594,1242,148,1390,200,en,4.59017,1496
1056,2269,437,1098,109,1207,200,en,3.029251,1497
1057,4810,653,1733,163,1896,200,en,4.099134,1498
1058,2755,400,1219,100,1319,200,en,2.892889,1499
1059,6007,736,2035,184,2219,200,en,5.220348,1500
1060,5258,906,1869,226,2095,200,en,5.641466,1501
1061,2820,529,1246,132,1378,200,en,4.557789,1502
1062,4730,763,1726,190,1916,200,en,5.916094,1490
1063,5958,969,2042,242,2284,200,en,5.955487,1492
1064,1108,243,1087,108,1195,200,ru,3.139502,1504
1065,944,283,1001,126,1127,200,ru,3.906673,1505
1066,707,157,909,68,977,200,ru,1.960335,1506
1067,1035,429,1061,195,1256,200,ru,5.037904,1507
1068,1158,374,1118,170,1288,200,ru,3.910979,1508
1069,530,102,829,44,873,200,ru,2.000331,1509
1070,1401,407,1231,186,1417,200,ru,4.713189,1510
1071,866,287,984,134,1118,200,ru,3.307367,1511
1072,726,343,923,155,1078,200,ru,5.160172,1512
1073,1669,471,1338,217,1555,200,ru,5.249674,1513
1074,1170,332,1130,154,1284,200,ru,3.945719,1514
1075,792,270,955,122,1077,200,ru,3.979303,1515
1076,1664,439,1330,197,1527,200,ru,5.998366,1516
1077,949,551,1019,249,1268,200,ru,6.38514,1517
1078,1048,157,1070,73,1143,200,ru,2.110962,1542
1079,850,353,981,160,1141,200,ru,4.029751,1518
1080,1063,374,1077,173,1250,200,ru,3.83849,1519
1081,1473,308,1256,139,1395,200,ru,4.54352,1520
1082,906,192,994,82,1076,200,ru,2.569806,1521
1083,1200,397,1140,177,1317,200,ru,4.779919,1522
1084,1793,460,1409,212,1621,200,ru,5.075035,1526
1085,1685,388,1343,172,1515,200,ru,5.252275,1527
1086,7542,769,2420,192,2612,200,en,5.166689,1528
1087,7433,753,2390,188,2578,200,en,4.868081,1529
1088,4349,836,1618,209,1827,200,en,5.635417,1530
1089,5679,561,1954,140,2094,200,en,4.717126,1531
1090,3865,545,1499,136,1635,200,en,4.234379,1532
1091,3958,570,1521,142,1663,200,en,4.801292,1533
1092,3914,619,1509,154,1663,200,en,4.551205,1534
1093,2709,595,1207,148,1355,200,en,4.914965,1535
1094,8717,1148,2709,287,2996,200,en,9.706667,1536
1095,1685,374,1343,166,1509,200,ru,5.597995,1527
1096,7542,1048,2420,262,2682,200,en,7.243217,1528
1097,7433,677,2390,169,2559,200,en,4.38141,1529
1098,4349,767,1618,192,1810,200,en,5.333776,1530
1099,3865,573,1499,143,1642,200,en,4.522973,1532
1100,2709,593,1207,148,1355,200,en,4.376232,1535
1101,1481,352,1267,155,1422,200,ru,4.139072,1543
1102,1755,431,1389,196,1585,200,ru,5.055343,1544
1103,1027,499,1043,229,1272,200,ru,5.493967,1545
1104,631,137,883,63,946,200,ru,1.830108,1546
1105,3063,512,1297,128,1425,200,en,4.305941,1563
1106,1755,620,1389,279,1668,200,ru,6.463908,1544
1107,631,139,883,64,947,200,ru,2.02814,1546
1108,1298,435,1185,201,1386,200,ru,5.651862,1547
1109,468,313,794,139,933,200,ru,5.334792,1548
1110,2049,435,1519,196,1715,200,ru,5.960153,1549
1111,2263,161,1621,74,1695,200,ru,2.24362,1550
1112,4043,818,2454,377,2831,200,ru,8.957355,1551
1113,3048,610,1983,277,2260,200,ru,7.162898,1552
1114,20248,1105,9673,493,10166,200,ru,13.540411,1553
1115,2923,362,1888,163,2051,200,ru,3.75935,1558
1116,2763,669,1870,310,2180,200,ru,6.168261,1559
1117,468,253,794,110,904,200,ru,4.007185,1548
1118,2049,446,1519,201,1720,200,ru,5.70223,1549
1119,2263,599,1621,273,1894,200,ru,7.549081,1550
1120,3048,549,1983,248,2231,200,ru,7.378969,1552
1121,1051,430,794,107,901,200,en,3.398515,1564
1122,6617,826,2186,206,2392,200,en,6.648399,1565
1123,3465,600,1399,150,1549,200,en,4.19198,1566
1124,1346,267,1186,117,1303,200,ru,3.255874,1567
1125,2566,543,1757,247,2004,200,ru,6.05394,1569
1126,475,236,806,106,912,200,ru,3.273634,1570
1127,1450,336,1246,152,1398,200,ru,3.719602,1571
1128,3304,523,1384,130,1514,200,en,4.855508,1595
1129,6448,619,2165,154,2319,200,en,5.64985,1596
1130,4098,525,1567,131,1698,200,en,4.378416,1597
1131,6617,724,2186,181,2367,200,en,5.210266,1565
1132,1122,203,1109,94,1203,200,ru,2.627986,1572
1133,1667,328,1350,146,1496,200,ru,4.319989,1573
1134,810,199,953,91,1044,200,ru,2.989719,1574
1135,2698,617,1216,154,1370,200,en,5.945364,1598
1136,3176,638,1326,159,1485,200,en,4.197729,1599
1137,2687,626,1219,156,1375,200,en,4.565206,1600
1138,1667,270,1350,119,1469,200,ru,3.524628,1573
1139,810,232,953,105,1058,200,ru,3.54891,1574
1140,1349,245,1209,114,1323,200,ru,3.352493,1577
1141,2482,306,1721,137,1858,200,ru,4.393682,1578
1142,1639,622,1334,287,1621,200,ru,6.887773,1579
1143,1981,457,1493,212,1705,200,ru,5.178841,1580
1144,1623,492,1340,228,1568,200,ru,5.389258,1581
1145,1981,548,1493,254,1747,200,ru,5.889048,1580
1146,1623,475,1340,220,1560,200,ru,5.560717,1581
1147,1459,342,1254,155,1409,200,ru,3.95198,1582
1148,3247,417,2075,192,2267,200,ru,4.984669,1583
1149,936,492,770,123,893,200,en,4.174276,1584
1150,484,274,656,68,724,200,en,2.249476,1585
1151,2337,546,1124,136,1260,200,en,4.538009,1586
1152,3229,540,1343,135,1478,200,en,4.500837,1587
1153,7897,1022,2540,255,2795,200,en,8.216508,1588
1154,4357,596,1625,149,1774,200,en,4.280295,1589
1155,484,274,656,68,724,200,en,2.112554,1585
1156,2337,525,1124,131,1255,200,en,4.243253,1586
1157,3229,542,1343,135,1478,200,en,4.119875,1587
1158,7897,892,2540,223,2763,200,en,6.317331,1588
1159,4357,596,1625,149,1774,200,en,4.536425,1589
1160,2639,569,1197,142,1339,200,en,3.990308,1602
1161,2249,542,1106,135,1241,200,en,3.882182,1603
1162,1876,296,1448,134,1582,200,ru,4.912456,1604
1163,8065,1243,4233,564,4797,200,ru,12.561501,1605
1164,4143,357,2471,163,2634,200,ru,4.781497,1606
1165,3148,191,2018,85,2103,200,ru,3.875444,1610
1166,5014,393,2861,170,3031,200,ru,7.36361,1611
1167,2406,501,1143,125,1268,200,en,4.082378,1815
1168,2249,539,1106,134,1240,200,en,4.950203,1603
1169,1876,349,1448,157,1605,200,ru,5.758508,1604
1170,8065,634,4233,290,4523,200,ru,7.263415,1605
1171,752,47,938,20,958,200,ru,1.108779,1614
1172,3391,334,2105,149,2254,200,ru,5.004096,1615
1173,4839,415,2755,188,2943,200,ru,5.721003,1616
1174,3225,253,2043,115,2158,200,ru,3.729623,1617
1175,3727,376,2287,170,2457,200,ru,5.932873,1620
1176,3948,237,2394,105,2499,200,ru,4.008039,1621
1177,4945,342,2865,154,3019,200,ru,4.730583,1622
1178,79054,829,36210,374,36584,200,ru,12.291179,1623
1179,3052,520,1304,130,1434,200,en,4.209017,1624
1180,2636,710,1199,177,1376,200,en,5.154143,1625
1181,678,157,906,73,979,200,ru,2.079959,1634
1182,3391,406,2105,174,2279,200,ru,7.051606,1615
1183,3225,376,2043,170,2213,200,ru,6.102995,1617
1184,2144,529,1079,132,1211,200,en,5.805503,1626
1185,3609,586,1442,146,1588,200,en,4.935293,1627
1186,2767,729,1225,182,1407,200,en,5.335769,1628
1187,7534,938,2415,234,2649,200,en,7.584158,1629
1188,422,186,783,84,867,200,ru,2.475137,1630
1189,1606,810,1301,364,1665,200,ru,14.116006,1631
1190,1549,342,1310,158,1468,200,ru,4.558375,1632
1191,1439,480,1241,219,1460,200,ru,5.267917,1633
1192,1253,190,1172,87,1259,200,ru,3.079623,1635
1193,873,201,996,94,1090,200,ru,2.611427,1636
1194,815,235,962,109,1071,200,ru,2.768182,1641
1195,910,143,1003,66,1069,200,ru,4.013815,1642
1196,785,263,935,110,1045,200,ru,5.683712,1652
1197,1755,452,1276,193,1469,200,ru,5.432273,1653
1198,1218,342,1124,154,1278,200,ru,3.78606,1654
1199,934,523,1012,229,1241,200,ru,6.572421,1655
1200,1784,471,981,117,1098,200,en,4.084759,1816
1201,2405,494,1138,123,1261,200,en,3.880624,1817
1202,739,240,906,112,1018,200,ru,3.468419,1656
1203,2429,756,1696,347,2043,200,ru,8.293054,1657
1204,1680,501,1352,226,1578,200,ru,5.970403,1658
1205,2062,583,1524,261,1785,200,ru,7.430503,1661
1206,2429,733,1696,338,2034,200,ru,7.064258,1657
1207,1680,475,1352,214,1566,200,ru,6.215503,1658
1208,1499,472,1268,217,1485,200,ru,4.894825,1662
1209,1077,324,1085,149,1234,200,ru,3.87402,1663
1210,2103,873,1554,394,1948,200,ru,11.547286,1668
1211,617,86,864,40,904,200,ru,1.530988,1672
1212,706,199,912,88,1000,200,ru,2.768399,1673
1213,2129,390,1561,178,1739,200,ru,4.643068,1674
1214,2056,403,1526,184,1710,200,ru,4.383263,1680
1215,2743,395,1827,172,1999,200,ru,6.524576,1681
1216,3039,581,1961,262,2223,200,ru,8.0205,1682
1217,2880,392,1893,175,2068,200,ru,5.738308,1683
1218,1414,303,1228,138,1366,200,ru,3.554779,1684
1219,8270,656,4298,302,4600,200,ru,5.800472,1685
1220,2487,608,1729,282,2011,200,ru,7.756685,1686
1221,1513,138,1285,63,1348,200,ru,2.505843,1687
1222,9383,1361,4913,622,5535,200,ru,14.874526,1688
1223,3602,526,1435,131,1566,200,en,5.383423,1689
1224,2513,548,1168,137,1305,200,en,5.341309,1696
1225,2044,405,1046,101,1147,200,en,3.586505,1702
1226,3607,677,1451,169,1620,200,en,5.021193,1703
1227,775,405,947,179,1126,200,ru,6.393852,1704
1228,1045,350,1055,160,1215,200,ru,4.525303,1705
1229,1337,422,1200,193,1393,200,ru,4.593112,1706
1230,9913,692,5087,307,5394,200,ru,8.25593,1707
1231,1996,567,1495,256,1751,200,ru,6.457056,1708
1232,3726,652,1477,163,1640,200,en,5.819867,100
1233,1560,161,1313,73,1386,200,ru,1.942996,1709
1234,1402,506,1220,230,1450,200,ru,6.387083,1710
1235,1237,258,1156,117,1273,200,ru,4.227334,1712
1236,1665,336,1345,154,1499,200,ru,4.125395,1713
1237,2794,316,1843,139,1982,200,ru,3.967351,1714
1238,1145,457,1112,206,1318,200,ru,6.493938,1715
1239,1402,385,1220,174,1394,200,ru,5.392455,1710
1240,1024,98,1044,43,1087,200,ru,2.463798,1716
1241,878,176,988,80,1068,200,ru,2.672236,1717
1242,1204,223,1139,101,1240,200,ru,2.779698,1718
1243,1340,369,1207,171,1378,200,ru,5.138714,1719
1244,1175,286,1130,131,1261,200,ru,4.349827,1720
1245,1175,369,1130,167,1297,200,ru,4.904263,1720
1246,2198,267,1611,124,1735,200,ru,3.613974,1721
1247,1038,359,1057,162,1219,200,ru,5.363832,1722
1248,838,181,968,82,1050,200,ru,2.714509,1723
1249,4756,437,2742,198,2940,200,ru,6.338682,1724
1250,5480,690,3030,318,3348,200,ru,8.988975,1725
1251,3449,439,2133,197,2330,200,ru,5.845062,1726
1252,4421,327,2545,147,2692,200,ru,4.481163,1727
1253,6526,226,3532,104,3636,200,ru,3.881297,1728
1254,3598,359,2217,162,2379,200,ru,4.932587,1730
1255,5480,705,3030,324,3354,200,ru,12.949361,1725
1256,3449,286,2133,126,2259,200,ru,6.100665,1726
1257,3598,319,2217,145,2362,200,ru,4.332177,1730
1258,1144,385,1107,175,1282,200,ru,4.696313,1737
1259,3729,409,2284,179,2463,200,ru,5.301704,1738
1260,9279,1000,4709,448,5157,200,ru,15.11485,1739
1261,9281,527,4777,242,5019,200,ru,5.778863,1740
1262,346,125,750,58,808,200,ru,2.040577,1741
1263,3237,538,2040,245,2285,200,ru,7.192402,1742
1264,3426,831,1413,207,1620,200,en,6.038317,1743
1265,2150,733,1078,183,1261,200,en,4.905623,1747
1266,1074,388,803,97,900,200,en,3.557902,1748
1267,347,164,619,41,660,200,en,1.463165,1749
1268,5449,657,1912,164,2076,200,en,5.51741,1750
1269,3729,363,2284,160,2444,200,ru,5.771916,1738
1270,346,125,750,58,808,200,ru,1.93338,1741
1271,3426,799,1413,199,1612,200,en,6.235811,1743
1272,1293,515,1178,234,1412,200,ru,6.531583,1756
1273,5335,921,3018,418,3436,200,ru,10.554765,1757
1274,490,195,654,49,703,200,en,2.343877,1758
1275,531,218,666,54,720,200,en,1.915764,1760
1276,656,321,698,80,778,200,en,2.36936,1761
1277,471,220,649,55,704,200,en,1.96552,1762
1278,594,136,684,34,718,200,en,1.922836,1763
1279,393,246,768,110,878,200,ru,2.592627,1764
1280,490,161,654,40,694,200,en,1.896432,1758
1281,447,231,796,105,901,200,ru,3.02515,1767
1282,210,114,688,53,741,200,ru,1.788814,1768
1283,282,174,721,80,801,200,ru,2.612889,1769
1284,483,353,817,164,981,200,ru,4.285376,1770
1285,332,250,739,111,850,200,ru,3.208769,1773
1286,401,246,774,111,885,200,ru,2.968617,1774
1287,210,102,688,47,735,200,ru,1.763248,1768
1288,483,340,817,158,975,200,ru,3.787462,1770
1289,558,240,833,103,936,200,ru,2.823518,1775
1290,487,308,812,138,950,200,ru,4.178087,1776
1291,1331,283,1175,123,1298,200,ru,3.047319,1777
1292,289,198,720,89,809,200,ru,2.545655,1778
1293,192,120,675,53,728,200,ru,1.738167,1780
1294,73,52,625,24,649,200,ru,1.2378,1781
1295,289,169,720,76,796,200,ru,2.158067,1778
1296,192,79,675,32,707,200,ru,1.713558,1780
1297,73,63,625,29,654,200,ru,1.416446,1781
1298,2412,668,1137,167,1304,200,en,4.017947,1784
1299,4424,458,1675,114,1789,200,en,4.389264,1785
1300,2962,489,1273,122,1395,200,en,4.641223,1786
1301,2964,565,1276,141,1417,200,en,4.643075,1787
1302,2715,589,1211,147,1358,200,en,5.617647,1788
1303,2888,448,1275,112,1387,200,en,4.899847,1789
1304,1727,326,969,81,1050,200,en,2.954445,1790
1305,2964,483,1276,120,1396,200,en,3.49877,1787
1306,2715,614,1211,154,1365,200,en,4.904918,1788
1307,935,354,764,88,852,200,en,3.203419,1793
1308,1002,297,784,74,858,200,en,2.59888,1794
1309,1262,284,846,71,917,200,en,2.33371,1795
1310,978,304,777,76,853,200,en,3.006769,1796
1311,1004,320,784,80,864,200,en,2.849189,1797
1312,1120,357,812,89,901,200,en,3.430516,1798
1313,945,336,767,84,851,200,en,2.886516,1799
1314,1051,344,799,86,885,200,en,5.822964,1800
1315,1131,336,814,84,898,200,en,2.633224,1801
1316,849,311,744,77,821,200,en,3.771799,1802
1317,1142,439,818,109,927,200,en,2.883432,1803
1318,998,292,1036,132,1168,200,ru,4.149692,1834
1319,2359,550,1130,137,1267,200,en,3.98349,1804
1320,2598,550,1196,137,1333,200,en,6.74738,1805
1321,2053,444,1045,111,1156,200,en,3.956229,1806
1322,3997,729,1566,182,1748,200,en,5.408855,1807
1323,2653,352,1198,88,1286,200,en,3.105052,1808
1324,2775,600,1237,150,1387,200,en,4.55355,1809
1325,2598,549,1196,137,1333,200,en,4.849592,1805
1326,2053,421,1045,105,1150,200,en,3.409654,1806
1327,3997,712,1566,178,1744,200,en,5.325685,1807
1328,2653,424,1198,106,1304,200,en,3.814326,1808
1329,2775,614,1237,153,1390,200,en,5.370735,1809
